#######################
#*...................*#
#.#######.#.#.#######.#
#..A......#.#.........#
#.######.##.##.######.#
#.#......#P O#......#.#
#.#.######   ######.#.#
#.#......#R B#......#.#
#.######.##.##.######.#
#.........#.#.........#
#.#######.#.#.#######.#
#*...................*#
#######################
